1111111111111
1111111111111
10010000001C1
1000011111001
10P001E000T01
10000000000C1
1111111111111
1111111111111