111111111111
100001000001
1P000T0000E1
10000C100001
111111111111